12,6
###.####.###
#A.......B##
..###.###...
####...#####
###......###
###.####.###
