12,6
############
#..........#
#.#B##.#.#.#
#.####.#.#.#
#........A.#
############
