12,6
###0####0###
#A0099990B##
99###.###999
####...#####
###000000###
###0####0###
