44,31,3
############################################
#...#.........##############################
#.T.#.M....M..##############################
#...#.........################..############
##M#####..####################..############
#...####..#....################.#....#######
#...####..#.C........................#######
#...#.....###.######.#####.###.##....#######
#.M....#..#.C..#M..#.#H#C#.#....############
#...#..#.......#...#.#.#.#.#....############
##################.#.#.#.#.#....############
#............#...#.....#.#.#################
#...#######......#######.#.................#
##.##.....####.C.........#################.#
#...#.#.#.#......#######H############....#.#
#......M..###..######################.##.#.#
#...#.#.#.#......#.C.#...#............#HC#.#
#...#.....#...M........C...##########.#C.#.#
#...###.###......#.C.#...#.....#...M#.##.#.#
#...#.....####################.#....#....#.#
##.##..M..##.#...........#.....#M...######.#
##.##.....##........#.C..#..M..####..#..#..#
##.####.####.####.###....#.....#........#..#
#...###......#..MMM.#....#####.M.########..#
#.H.##########..MMM.##.###.....#........#..#
#...##.M..#######.###..#.#.....###..###.#..#
######.#..#...###.#..M...#H....#.C..#...#..#
#...#..#....C.....#....#.#######.C..#...#..#
#.P...M####...#.#.######.#.....H.C..#..##..#
#...#..####.M.#H#........#.......C..#......#
############################################
